20
17
0 0 0 0 0 0 7 7 7 0 0 0 0 0 0 0 0 0 0 0 
0 0 0 0 0 7 7 7 7 7 0 0 0 0 0 0 0 0 0 0 
0 0 0 0 0 7 7 7 7 7 0 0 0 0 0 0 0 0 0 0 
3 3 0 0 0 0 0 6 0 0 0 0 0 0 0 0 0 0 4 4 
2 2 0 0 0 0 0 6 0 0 0 0 0 0 0 0 0 0 4 4 
2 2 0 0 0 5 0 6 0 0 0 0 0 0 0 0 0 0 4 4 
2 2 3 3 3 3 3 3 3 3 4 4 4 4 4 4 4 4 4 4
2 2 2 2 2 2 2 2 2 2 4 4 4 4 4 4 4 4 4 4
1 1 1 1 1 1 1 1 1 1 1 1 1 1 1 1 1 1 1 1
1 1 1 1 1 1 1 1 1 1 1 1 1 1 1 1 1 1 1 1
1 1 1 1 1 1 1 1 1 1 1 1 1 1 1 1 1 1 1 1
1 1 1 1 1 1 1 1 1 1 1 1 1 1 1 1 1 1 1 1
1 1 1 1 1 1 1 1 1 1 1 1 1 1 1 1 1 1 1 1
1 1 1 1 1 1 1 1 1 1 1 1 1 1 1 1 1 1 1 1
1 1 1 1 1 1 1 1 1 1 1 1 1 1 1 1 1 1 1 1
1 1 1 1 1 1 1 1 1 1 1 1 1 1 1 1 1 1 1 1
1 1 1 1 1 1 1 1 1 1 1 1 1 1 1 1 1 1 1 1